####### #######
#.....# #.....#
#.....###.....#
#..<...+...>..#
#.....###.....#
#.....# #.....#
####### #######