           
 ######### 
 #       # 
 # ## ## # 
   #   #   
   #   #   
   #   #   
 # ## ## # 
 #       # 
 ######### 
           


37
38
39
40

65
87
68
83