...........
.#########.
.#.......#.
.####.####.
..#.....#..
..###.###..
..#.....#..
.####.####.
.#.......#.
.#########.
...........