           
 ######### 
 #.......# 
 ####.#### 
  #.....#  
  ###.###  
  #.....#  
 ####.#### 
 #.......# 
 ######### 
           