#####################
#...................#
#.#####.............#
#.#...#.............#
#.#...#.............#
#.#.................#
#.###.#.............#
#...................#
#...................#
#...................#
#...................#
#...................#
#...................#
#...................#
#####################