###############
#          >  #
#  >          #
#             #
#~  >     ^^^ #
#~~~~      >^^#
#~~~~~    ^^^^#
###############