#####################
#.........#.........#
#.#########.#######.#
#.#...#...#.....#.#.#
#.#.#.#.#.#####.#.#.#
#...#.#.#.#.....#.#.#
#.###.#.#.#.###.#.#.#
#.....#.#.#.#...#.#.#
#.#####.#.#.#####.#.#
#.......#.#.....#.#.#
#.#######.#####.#.#.#
#.....#.#.......#.#.#
#.#####.#.#######.#.#
#...................#
#####################