#####################
#.........#.........#
#.#########.#######.#
#.#...#...#.....#.#.#
#.#.#.#.#.#####.#.#.#
#...#.#.#.#.....#.#.#
#####.#.#.#.###.#.#.#
#.....#.#.#.#...#.#.#
#.#####.#.#.#####.#.#
#.......#.#.....#.#.#
#.#######.#####.#.#.#
#.....#.#.......#.#.#
#.#####.#.#######.#.#
#.......#.........#.#
#####################